.....................................................####
.........................................x...........####
.....................................................####
......"""".................x.......#..#####...###....####
.x...........................##......................####
""""""##.....#.....x..................#..............####
##xxxx......#........................................####
##xxxx...#####............."..."""""....................#
######"""################################################
